#######################################################################
#A    #       #           #                       #     #           # #
##### # ### # # ########### ########### ##### ##### ### # ####### # # #
#   # # #   #   #           #   #       #   # #     # # #       # #   #
# ### ### ##### # ########### # # ######### # # ##### # ####### # #####
#   # #   #     # #       #   # #     #     # # #     #         #     #
# # # # ####### # ##### #   # # # ### ### ### # ### # ############### #
# #   #       # #   #   # # # # #   # #   #   #   # # #             # #
# ########### # ### # ### ###   ### # # # # ##### # # # # # #######   #
#           # # #     #       #   # # # # # # #   # #   # # #   #     #
########### # ### ############### # # # ### # # ### ##### # # # ##### #
# #     #   #   #   #   # #       # # #       #           #   #   #   #
# # ### # ### # # ### # # # ####### # ############# # ### ##### # ### #
#     # # #   # # #     # # #       # #             # # #     # #   # #
####### # ### # # # ### # # ### ### # # ######### ### # ##### ##### ###
#   #   #   # #   #     #   #   #   #   #             #           #   #
# # # ##### # ####### # ### # ### ####### ############# ######### # # #
# #   #     #   #     #   #   # #       #   #         #   #   #   # # #
# ##### ######### ####### ##### ####### ### ######### ### # # ### ### #
#     # #         #     #   #         #   #         #     # #   #     #
# ### # # # ####### ####### ##### # ##### ######### # ##### ### ##### #
#   # # # #     # #       #     # #     #         # # #     # #     # #
##### # # ##### # # ##### ##### ##### # ########  # ### #  ## ##### ###
#     # #     # # # # #     #   #   # # #   #     #     #         #   #
# # ### ##### # # # # # ##### ### # ### # # # ########### ### ## #### #
# # #   #       # #   #       #   #     # #   #     #     #   #     # #
# ### ### ####### ### ##### ### ######### ##### ### # ######### ### # #
#   # #   #       #   #         #         #       #   #   #     #   # #
### # # ### ##### # ### ##### ### ##### ######### # ### # # ##### ### #
#   #   # #     # #   #     #   #                 # #   #   #   #     #
# # ##### # ##### ### ### # ### ### ### ### ######### # ##### # ##### #
#     #     #       #   # #       #   # #   #       # # #     # #   # #
# ### # ##### ##### ### ### ##### ### # # ### ##### # ### ##### # # # #
# # #   #   # # #   #     #   #   #   # # #   #     # #     #   # # # #
#   ##### # # # # ###  ## # # ##### ##### # ### ##### # ##### ### # # #
#         # # #   #     # # #           # # # #       #   #   #   #   #
########### # # ### ##### # ###### #### # # # ####### ### # ##### #####
#     #     # # #   #     # #       #   # # #   #     #   #     #     #
# ### # ##### # # ### ####### ##### # ### # # # # ##### ####### #######
#   # # #     #   #   #     #   # # #     # # #       # #     #   #   #
# # ### # ####### # ### ### # # # # ##### # ########### ### # ### # # #
# #   # #       # #     # # # # # # # #               #   # #   #   # #
# ### # ####### ######### # ### # # # # ##### ### ### ### # ### ##### #
# #   # #     #           #     # # #     #     #     # #   #   #   # #
### # # # ### ##### # ### ####### # ##### ##### # ### # ##### # # ### #
#   # # #   #     # #   #         #   #         #   #   #     #     # #
# ##### ##### ### # ### # ########### ######### ### ### # # # # ### # #
#       #   #   #     # # #         #   #   #   # # #   # # # # #   # #
# ####### # ### # ##### # # ##### # ### # ### ### # ##### # # ### # # #
# #   #   #     # #     # #   #   # # # #         #       # # #   # # #
# # # ### ##### ### # ##### ### ### # # # ######### ####### # # ##### #
# # #     # #   #   # #     #   #   # # # #       # #     #     #     #
# # ####### # ### ##### ##### ##### # # ### ##### # # ### ####### ### #
# #   #   #   # #       #   #     #   #     #   # # # #   #   #   #   #
# ### ### # ### ######### ####### ########### # # # # # ### # # ### ###
#     #   #       # #           #   #   #   # #   #   # #   #   # #   #
####### ######### # # ######### ### # # # # # ####### ### # ##### ### #
#       #       # #   #       #   # # #   # #   #   # #   # #   # #   #
# ##### # ### ### ##### ##### ### # # ### # ### # # ### ##### # # #  ##
# # #   #   #     #   # #   #   # # #   #     # # #   #       # #     #
# # # ##### ####### # # # ##### # # ### # # ### # ### ##### ### ####  #
# #   #     #   #   # # #       # #     # # #   # # # #   #   #   #   #
# ##### ##### # # ### # # ####### ####### ### ### # # # # ### ### ### #
#       #     # #   #   #       #       #   #     # #   # # #   #   # #
# ####### # ### ### ########### # ##### ### ####### ##### # # ##### # #
# #   #   # #       # #   #     # #     # #         #   # #   #   # # #
# # ### ### ######### # # # ####### ### # # ######### # # ##### # # # #
# #       #         # # # # #   #   #   # #   #       # #       # # # #
# ############## ## # # #   # # # ### ### ### # ####### #########     #
#                   #   #     #   #         #         #             #B#
#######################################################################