#######################################################################
#A#     #       # #   #       # #       #     #       #     #   #     #
# # ##### # ### # # # # # ### # # ### # # ### # ### # ### # # # # ### #
# #       # #   #   # # # # # #   # # # #   # # # # #     # # #   #   #
# ######### # ### ### # # # # # ### # ##### # # # # ####### # ##### # #
#           # #     #   # # # #     #     # #     # #       #     # # #
############# ########### # # ### ##### ### ##### # # ########### # # #
#   #       #             #       #   # #   #   # # # #         # # # #
# # # # ################### ####### # # # ### # ### # # ##### ### # ###
# #   #               #     #   #   #   # #   #     # #   # #         #
# ######### ### ####### #####   # ####### # ######### ### # ##### ### #
# #         #   #   #   #         #     # #   #     # #   # #   #   # #
### ####### ##### # # ### ### # ### ### # ### # ### ### ### # # # # # #
#   #   #   #     #   #   # # # #   # #       #   # #       # #   # # #
# ### # ##### ########### # # # # ### ##### # ### # # ####### ##### # #
# #   #     # #         #   # # #     #   # #   # #     #     #     # #
# # ####### # # ####### ##### # ##### # ### ##### ####### ##### ##### #
#       #   # #       #       #     # #   #   #   #   #   #   # #   # #
######### # # ####### ############  # ### # # # ### # # # # # # # # # #
#         # #       # #       #     #   # #     #   # # # # # #   #   #
# ##### ########### # # ### # ######### # # ### ##### # ### # #########
# # #   #         # # #     #     #     # #   # #   #       #   #     #
# # # ### ####### # # ##### ##### # ##### ### # # # # ##### ### # ### #
# #   #   #     # # #     # #   # # #     # # # # #   #   #   #   #   #
# # ### ### ##### # ##### # # ### # # ### # # # # # ### # ######### # #
# #   #   #     # #   #   #   #   #   # # # #     # #   #           # #
# ####### ##### # ### # ##### # ####### # # ######### ############### #
#         #     # #   #   #   # #     #   #   # #     #             # #
# ######### ### # # ### # # ### # ### # ### # # # ##### # ####### ### #
#   #     #   # #   # # # #   # # # # # #   # # #     # # #     # #   #
### ##### # # # ##### # # # # # # # # # ### # # ##### # ### ### ### ###
# #     #   # #     #   # #   #     #       # # #     #   # # #   #   #
# ##### ##### # ##### ### # ################# # # ##### # #   ### ### #
#   #   #     # #       #       #         #     # #   # # #     #   # #
# # # ### ##### # ####### ####### ####### # ##### # # # # ### ##### # #
# # # #   #   #     #   #   #   # #     # # #   #   # # #     #   # # #
#   # # ### # # ##### # # ### # # ##### # # # # # ### # # ##### # # # #
# # # #     # # # #   #   #   # # #   # # # # # #   # #         #   # #
### # ####### # # #  #### # ### # # # # # ### # ###   ##### ##### # # #
#       #   #   # #     #   #     # #   #   # # #   #     # # #   #   #
# # # # # # ### # ##### ########### ### ### # # ##### ### # # # ### ###
# # #   # #   #       #   #       #   #   #   #     # #   # #   #   # #
# ### ### ### ######### # # ##### ### # ####### # # # # ### ##### ### #
#     #   # #     #   # #           # # #     #   # # #   # #     #   #
# ##### ### ##### # # ######### ### # ### #   ##### ### # # # ##### ###
#       #     #     # #   #         #     # #     #   #   #     #     #
######### ### # ##### #   ####### ### ##### ##### ### # # ## ## # ### #
#         #     #     # #       # # #     # #     #   # #     # # #   #
# ####### # ##### ##### # # ### # # ### ### # ##### ### ##### # # # # #
# #   # # # # #   #     #   # #   #     #   #   # # #   #     # # # # #
# # # # # # # # ### ######### ##### ## ## ##### # # ##### ##### # # ###
# # # # # # # # #     #     #       #   #     #   #       #   # # #   #
# # # # # # # # ##### # # ### ####### #   ### ############# # # ##### #
#   #     # # # #     # #     #       # # # # #       #     # #   #   #
####### # # # # # ### ### ##### ####### # # # # # ### # ##### ### # # #
#       # #       #     #   #   #   #   # # #   # #     #   #   #   # #
# ####### # ####### ### ### # ### # ### # # ##### ####### ##### ##### #
#         # #       #   #   # #       # #     # #   #           #     #
# ######### # # ####### ##### # ##### # ##### # ### # ########### #####
#   #       # # #     # #   # #     # # #   #   #   #   #         #   #
# #   ####### # # ### # # # # ##### # # # # ##### ##### # ######### # #
# # #   # #   #     # #   # #     # # #   #   #   #     #   #       # #
# # ### # # ####### # ##### # ### # # ####### # # # ####### ##### ### #
# #   #   # #     #   #     #     # #   #   # # #   #     # #   # #   #
# ### ##### # # # # # ##### ### # # ###   ### # # ### ### # # #   #####
# # #     # # # # #       #   # # # #   #     # # #   #   # # # #     #
# # ##### # # # ######### ### # ### # ##### ### # # ### ### # # ### # #
# #     # # # #     #   #   #   #   # #   #     # #   #     # #   # # #
# ### # # # ##### # # # ### ## ## ### # # ########### #### ## ### ### #
#     # #         #   #   #         #   #                     #      B#
#######################################################################