#######################################################################
#A#       #               #           #           #     #     #   #   #
# # ##### # ########### # # ####### # ### ####### # ### ### # # # # # #
# #     # # #           # # #   #   # #   #     #   #       # # #   # #
# ####### # # # ######### # # # # ### # # # ### # ### ####### # ##### #
#   #   #     #         # # # # #   #   # # # # # #   #     # #     # #
### # # ##### ######### ### # ##### ##### # # # ###   # ### # ##### # #
#   # #     # #   #     #   # #   #   #       #   # # #   # #   #   # #
# ### ## ## ### # # ##### ### # # ### ####### ### # # ## ## ### ##### #
# #   #   #   #     #     #     #   #         # #   #     #     #   # #
# ### # ##### # ##### ####### ##### ### ####### ##### ### ### ### # # #
# #   #     #         #       #   #           # #   #   #   #     #   #
# # ##### # # ### # ##### # ### # ##### ##### # # # ####### ###########
#         #     #     #   #     #     # #       # #       #           #
##### ##### ### ##### # ############# # ### ### # ####### ########### #
#     #       #     #   #       # #   #   # #     #   #           #   #
# # ### ##### ##### ##### ### # # # ##### # # ##### # ##### ##### # # #
# #   # #         #     # #   #   #       # #       #   #   #   #   # #
# ### # # # ##### # # ### # ##### ######### ########### ##### # ##### #
#   #   # # #   # # #     # #   #   #       #   #     #       #   #   #
# ### ### ### # ### ##### # # # ##### ######### # ### ### ####### ### #
# #       #   #     #   # #   #     #   #     # # # #   #   #   #   # #
### ### ### ######### # # ######### ### # ### # # # ### ##### # ### # #
#   #   #   #         # #     #   # #   #   # # # #   #       #   # # #
# ### ### ### # ### # # ##### # ### # ##### #   # ### ########### # # #
#     # #   # # #     #   #     #   #       # # #   #         #   # # #
# # # # ### # # ######### ##### # ########### # ### ### ##### # ### # #
# # #   #   # #   #     #   #   #           # #   #   #   # #   #     #
# # ### # ##### # ### # ### ######### ### ### # ##### ### # ##### ### #
# # #   #     # #   # # #   #       # # #   #   #   # #         #   # #
# # ### ##### ##### # # # ### ##### # # ### # ### # # ######### ### # #
# #   # #   # #     # # #     #   # # #   #   #   # #         #   # # #
##### # # # # # ####### ####### ### # ### ##### ### # ####### ### # # #
#     # # # # #       #     #     # #         # #       #   # # #   # #
# ## ## # ### ######  # ##### ### # ###########   ####### # # # ### # #
# #     # #   #       #         # #   #         #     #   # # #   #   #
# ### ### # ### ####### ######### ##  # ### ######### # ### # # ### ###
#   #     # #   #     #   #   #   #   # #   #     #   #   # # #     # #
# # ##### # # ##### # ### ### # ### ### # ### ### # ##### # # ### ### #
# #   #   #   #   # #   #     # #   #   # #     # #   #   # #   # #   #
# ### # ####### # ### # ##### # # ### ##### ##### ### # ### # # # ### #
# #   #         #     #   #   #   # #       #     #   # #   # # #     #
### # ########### ####### # ####### # # # ### ##### ### # ##### ##### #
#   # #       #   #   #   # #         # # #   # #   #   #       #   # #
# ##### ##### ### # # ##### # ######### # # ### # ### # ######### # # #
#       #   #       #       #     #   #   # #   # # #     #       # # #
# ####### # ##################### # # ##### ### # # # ### ##### ### # #
# #       #         #         # #   # #   #   #   #     #     #   # # #
# # ### # ##### ### # ####### # ##### # ##### # ####### ##### ### # # #
# # #   #     #   #   #     # #     #   #   # #     #     # # # # #   #
# ### # ######### ######### # # # ##### # # # ##### ##### # # # # #####
#     #   #     # #       #   # #   #   # #   #       #     # # #     #
######### # ### # # ##### # ### ### # ### ##### ##### ####### # ##### #
#       #   #   #   #   # #   #   # # #   #   # #   #   #     #       #
# ##### ##### ### ##### # ### # ### # # ### # ### # ### # ##### #######
#     #     #   # #   # # #   # #   # #     #       #   # #     #     #
##### ##### ### # # # # # #  ## # ### ########### # # ### # ##### # # #
#     # #   #   # # #   # #   # #         #   #     # #   # #   # #   #
# ##### # ### ### # # ### ### ### ### ##### # # ##### # ##### # # # # #
#   #   #   #   #   # #   # #   #     #   # #   # #   #       #     # #
### # # ### ### # ##### ### ### ####### # # ##### # ### ########### # #
# #   #   #   # # #   # #             # # # #   #   #   #         # # #
# ####### # ### # # # # ##### ####### # # # # ### ### ### ####### # # #
#       # # #   # # # #     #         # #   #     #     # #     # # # #
# ##### # # # ##### # ##### ### # ##### ##### ##### ##### # # ###   # #
# #   #   # # #     # #     #   # # #   #           #     # # #   # # #
# # # ##### # # # ### # ##### # # # # # # ####### ### ####### # ### # #
# # #       # # # # # #   #   # # #   # # #     # #   #       # #   # #
# # ######### ### # # ### # ##### ##### # ### # ### ###   ##### ### # #
# #               #       #             #     #     #   #           #B#
#######################################################################