#######################################################################
#A#               #       #       #             #             #   #   #
# # ########### # # ## ## # # ### # # ##### ### # ####### # ### # # # #
# # #         # # #     #   #   # # # #   #   # # #       # #   #   # #
# ### ####### # ####### ####### ### # # ### # # # #  ######## ####### #
#   # #     # #       #       #     # # #   #   # #     #     #     # #
### # # ### # ### ### # ########### # # # ############# # ##### ### # #
#   # #   # #   # #   # #         # # # #     #         # #   # #   # #
# ### ### # # # ### ### # ####### ### # ##### # ######### # ### # ### #
#   #     # # #   #     # #     #     #         #           #   #     #
### ### ### # ### # ##### ##### ##### ##### ##### ########### ####### #
# #     #   #   # #     # #   # #     #   # #   # #   #       #     # #
# ### ### ### # # # ## ## # # # # ##### # # # # # ### # ####### ### ###
#   #     #     # # #   #   # #   #     # # # #   #   #         # #   #
# # ####### ### # ### # ## ## ###   ##### ### ##### # ########### ### #
# #     #   # # #     #     #   # # #   #     #     #           #   # #
# # ### # # # # ########### ### # # ### ## #### # ##### # ##### # # # #
# # #   #   #   #     #   #   # # #         #     #   #   # #   # # # #
# # # ### # ### # ### # ##### # # # ####### ### ### ####### # ### # # #
# # #   # #   #   # # #     # # # # #     #     #         #   #   #   #
### # # ##### ##### # ### ###   ### # ### ####### ##### # # ### # ### #
#   #       #   #   #   #   # #     #   #       #   # # # #   # # #   #
# ######### # # ### ### # # # ##### ### ##### # ### # # ##### ### # # #
# #     # # # #   #     #   # #   #   # #     # #   # #           # # #
# # ### # # ####  # ####### # # # ### # # ##### # ### ############# # #
#     # #   #     #         #   #   # # # #     #     #         #   # #
# ### # # ### # ########### ####### ### # ##### ### # # ####### # ### #
#   # # #     #   #       #       # #         #     # #     #       # #
# # # # # ##### # # ############# # # ####### ### ### # ### ### # # ###
# # # # # #     # #         #   # #   #   # #   # #   #   #   # # #   #
# # ### # # ##### # ####### # # # ### # # # ### # # ### ##### # ##### #
# #     # # #   # # #     #   # # #     #   # # #       #     #     # #
# ### ### # # # # # # ### ##### # # ####### # # ####### # ######### # #
# #       #     # # # # # #   # #   #     #   # #   # # #   #   #   # #
# ##### # ##### # ### # # # # # ######### ### # # # # # ### ### # ### #
#       #     # #   #   # # # # #         #   #   # #     #   # #   # #
# ##### # ##### ### # ### # # # # # ####### ####### ####### # # ### # #
# # #   # #   # # #   #   # #   # #       # #     #   #   # # #   #   #
# # # ##### # # # ##### ### ##### ####### # ##### ### # # ### #  #### #
#   #       #   # #   # #               #   #       #   #     #     # #
### ############# # # # # ## ############ ### ################# ### # #
#   #     #         # # # #     #       #     #               #   #   #
# ### # ### ######### # ### ### # ### # ##### # ####### ##### ### #####
#   # # #     #       #   #   # #   # #     # # #   #   #   #   #     #
### # ### ##### ##### ### ### # ### # ##### # # # # # ### ##### ##### #
#   #   #   #   #   # # # #   #   # #     # # # # # # #       # #   # #
# ### # ### # ### # # # # # ### ### # ### # ###   # # ####### # ### # #
# #   #   # #   # # # # #     #   #       #     # # #       # #     # #
# ####### # ### # # # # ######### # ####### ####### ####### # ##### # #
#       # #   # # # # #     #     # #     #         #   #   #       # #
#######   # ### # # # # ##### ##### # ###   ## ###### # # ### ##### # #
# #     #   #   # #   # #   # #     #   # # #     #   # #   # #   # # #
# # # ### ### ### # ### # # # # ####### # # # ### # ### ### ### # # # #
#   #   # #   #     #   # # #   #       #     # # #   # #   #   # # # #
# ### # ### ### ##### ### # ##### # # ### ##### # # # # # # # ### ### #
#     #     #   #     #   #       #   # #           # #   # #   #     #
############# ####### # ######### ##### # ########### ##### ### #######
#           #   #   # #         # #   #           #   # #   # #     # #
# # ### ######  # # # ######### ### # ########### # ### # ### ##### # #
# # #   #       # #   #   #   # #   #         #     # #   #   #     # #
# # ### # # ##### ### ### # # # # ########### ####### # ### # # ##### #
#     # # #   #   # #     # #   # # #   #   #   #       #   # # #     #
# ### # # # # ### # ##### # ##### # # # # # ### ## ## ### ### # ##### #
# # # # #   # #   # #   #         #   #   #   #     #     #   #     # #
# # # ####### # ### # # # ############### ### ##### ##### ######### # #
# # # #     # # #   # #   #             #   #     # #   # #       #   #
# # # # ### # # ### # ##### # ##### ### ### # ##### # ### # # ####### #
# #     # #   #   # #     # #       # #   # #   #   #     # # #       #
# # ##### ####### # ##### # ######### ### ##### # ######### # # #######
#                 #         #                   #           #        B#
#######################################################################