#######################################################################
#A#     #   #         #         #                 #         #         #
# # ###   ### # ### ### # ##### ############# # ### # ####### # ##### #
#   # # #     #   # #   # #   #         #   # #     #         #   #   #
##### # # ####### ### ### # # # ####### # # ####### ######### ### #####
# #   #   #     # #   #   # # # #   #     # #     #         #   #     #
# #   ### # ### # # ### ### # ### # ####### # ### ### ##### # # ## ## #
#   #     #   #   # # #     #     #   #     # # #   # #   #   # #     #
# ######### # ##### # ##### ######### ##### # # ### ### # # ##### ### #
# #       # #                       #     #   #   #   # # # #     #   #
# ## ## ### ##### ##### ####### #####  ## ####### ### # # # # #########
# #   # #   #   # #   # #     # #   #     #         #   # # #         #
# # # #   ### # ### # ### ### ### # # ##### ### # ####### ########### #
#   # #     # #   # #     # # #   # # #   # # #         #         #   #
##### ####### ### # ####### # # ### # # ### # ####### ########### # # #
#   #   #   # #   # #       # # #   # #   #       # #           # # # #
# # ### # # # ### # # ### # # # # ### # # ##### # # ##### ####### # # #
#     #   # #   #   # #   # # # #     # # #       #     #     #   # # #
##### ##### ### ##### # # ### # ####### # # ########### ##### # ### # #
#     #   # #   #   #   #   #   #     # #   #           #   # # #     #
# ##### # # # ##### ### ### ##### ### # ####### ####### # ### # # ### #
# #     #   #     #       #   #   #   # #     #   #   # #   # # #   # #
# # ####### # ### # ######### # # # ### ### # # # # # # ### # # ##### #
# # # #       # # #     #     # # # #   #   # # #   # #     # #       #
# # # # ####### # ### ### ### # # # # ### ### # ##### ##### # ####### #
# # #           # # # #   # # # # # #     # # # #   #   #   #       # #
# # ########### # #   # ### # # # # ####### # # # # ### # ###   ### # #
# #               #   # # #     # # #       # # # #     # #   #   # # #
# ################# ### # # ### # # # ##### # ### # ##### # ##### # # #
#           #       #   # # #   # # #     #   #   # #     #     # #   #
# # ####### # ### ### ### # # ### # ######### # # ### # ##### # # #####
# #   #   #   #       #       #   #     #   #   # #   #     # # #     #
# ### # # ########### ####### # ####### # # ### ### ##### # # # ##### #
# # #   #         #   #       # #   #   # #   # #   #       #   # #   #
# # ############# ##### ### # # # # # ### ### ### ####### # # # # # ###
# #             #     # # #   #   # #     # #   #     #   #   # # # # #
# ############# ##### # # ####### # ####### ### # ### # ####### # # # #
#                   #   #   #       #       #   # #   #     #   # #   #
################### #####   # ### ####### ### ##### ##### ### ### ### #
# #           #   #     # # #   # #     #           #     #       #   #
# # ### ### # # # ##### ### ### ### ### ### ######### # # # ####### ###
#   # # #   #       #       #   #   #   #   #     #   # # #   #   #   #
# ### # # # ### # ### ##### # # # ### ### # # # ### ### # ### # # ### #
# #   #   # #     #   #   # # # #   #   # #   # #   # # # #   # #     #
# ### ##### # ##### ### # # # ##### ### # ##### # ### # ### ### #######
#       #   #   #   #   # # #   #   #   #     # # #   #     #   #     #
#### ## # ####### ### ### ##### # ### # ##### ### ### ####### ####### #
# #   # #         # # #   #     #   # # #             #     #     #   #
# # # # ########### # # ### ### # ### ### # ######### # # # ##### # # #
# # #   # #         # #   # #   # #   #   #     #   #   #       #   # #
# # ##### # ####### # ### # ##### # ### ####### # # # # ##### ####### #
#   #   #   # #   # # #     #   # # #   #     # # #   #   # # #       #
# ### ### ### # # # # ### ### # # # # ##### ### ####### # # # # #######
#   #     #   # #   #   # #   #   # # #   #   #         # #   #     # #
### # ##### # # ### ### ### ####### # # # ### ########### ### ##### # #
# # #   #   # #   #   # #   #     # #   #     #         #   #     # # #
# # # # ### # ### ### # # ##### # # ####### # ##### ### ### ##### # # #
#   # #     #   #   # #   #     # # #       #       #   # # #   # #   #
# ### ######### ### # ##### # ### # # ### ########### # # # # ### ### #
# #               # # #     #   # #   # #       #   #   # # #       # #
# # ############### # # ####### # ##### ##### #   ##### # # ### ##### #
# #     #   #       # # #       #     #   #   # #   #   # #   #   #   #
# ####### # # ####### # # #### ###### # # # ### ### # ### ### ## ## ###
#     #   #   #       # #   #       #   # # #     # # #     #       # #
##### #  ###### ######### # ### ### ## ## # ##### # # ##### ######### #
#     #   #     #       # #   # #   #   # # #   #   # #   # #       # #
# ##### # ### ##### ### ##### # ##### # # # # # ### # # # # # # ### # #
# #     #   #       # #       # #     # # #   # #   #   # #   # #   # #
# #   ##### ######### ## ###### # ##### # ##### # # ## ## ##### # ### #
#   #       #                         #       #   #             #    B#
#######################################################################