###################################################
#A#               # #               #     #       #
# ########### ### # # # # ######### ### # # ### # #
#     #       #   #   #   #     #   #   #   #     #
##### # ####### ### ### # # ### # # # #############
#   #   #     # #   #     #   # #   # #           #
# ########### # # ### ####### ##### # # ####### # #
#           # # # #   #       #     #   #       # #
# ### ##### # # ### ### ####### ##### ### ##### # #
# #   #     # #     # #         #     #   #     # #
### ### ##### ####### # ######### ##### ### ##### #
#   # # #         #     #         #     #   #   # #
# ### # ####### # # ##### ##### # # # ### ### # # #
#   #       #   # #   #     #     # # # # # # #   #
# # # ##### # ####### # ### # ####### # # # # #####
# # # #   # # #   #   #   #         # # # # #     #
### ### #     # # # ##### ######### # # # # ##### #
#   #   # # #   # # #   #   #   #     #     #   # #
# ### ### # ##### # # # ##### # # ######### # # # #
#       # #       #   #       # #   #   #     # # #
# ##### # ####### ############# ##### # ##### # # #
# #   # #   #             # #   #     #     #   # #
### # ###   ############# # # ### ######### ### # #
#   #   # #         #   # # #   #         # #   # #
# ##### # ####### # # # # # ### ######### # ##### #
#   #   # #     # # # # #     #           #     # #
### # ##### ### ### #   ##### ################# # #
#   # #     # #     # # # #   #           #     # #
# ### # ##### ####### # # # ### ### ### # # # ### #
#   # #   #       #   #   #   #   # #   # # #     #
# # # ### ### ### ### ####### ### # ### # # ##### #
#   #     #   #       #     #   #     # #   # #   #
# #### #### # # ####### # ### ### ### # ### # # ###
#   #     #   # #       #     #   #   #   # # # # #
# # # ### # # ### ############# ### ### #   # # # #
# # #   #   #   #         # #   # #   # # # # #   #
# # ####### ### ########  # # ### ### # ### # ### #
# #   #   #   #             # # #   # #         # #
# ### # # ### ##### ######### # # # # # ##### ### #
#   #   # #   #   #     #     #   # # # #   # #   #
### ##### ##### # ### ### ######### # ### # ### ###
#   #   #     # #   # #   #       # #     #   #   #
# ### # ##### # ### # # ### ##### # ######### ### #
# #   #     #       # # #   #   # #   #       #   #
# # ####### ####### # # # ### # # # # # ##### # ###
# # #     # #       # # #   # # #   #   #     # # #
# # # ##### # ### ##### # # # ####### # ##### # # #
# #   #   # #   # #   #     #       # # #   # # # #
# ##### # # ### ### # ####### ##### # # # # ### # #
#       #     #     #             #   #   #      B#
###################################################