###################################################
#A                  #     #     #       #         #
##### ####### # ### ### # # # ### ##### # ##### # #
#   #       # #   #   # # # #         # # #   # # #
# # ####### # ### ### ### # ######### # # # # # ###
# #   #   # #   #   # #       # #   # #   # # #   #
# # ### # # # ##### # # # ###   # # # ##### # ### #
# # #   #   # #     #   # #     # # #   #   # #   #
# # # ####### # ##### # ### ##### # ##### ### # ###
# #   #   #   # #   #   #   # #         # #   #   #
# ####### # ### # # ### #  ## # ####### # # ##### #
#   #   #     # # # #   #   # # #   #   # #   #   #
##  # # ####### ### # ##### # # # # ### # ### # ###
#   # #       #   #   #   #   #   #   #   # #     #
# ### ####### ### # ### # ##  ####### ##### # ### #
# #   # #   # #   # # # #     #   # #   #   #   # #
# ### # #   # # ### # # ####### # # ### # # ### # #
# #   # # # # #   # # # # #     #   #   # #   # # #
# # ### #   # ### # # # # # ### ### # ### ##### # #
#   #     # #   # #   # #       #   # #   #     # #
##### ##### ### # ##### # ##### # ### # # # ##### #
# #   # #   #   #   #   #   #   #   # # #     #   #
# # ### # ### ### # # ####### ##### # ####### # # #
# #   # #     #   # #     #       # #   #   # #   #
# ### # ####### ### ##### # # # # # ### # # # ### #
#   # #       # # #     #   # # # #   #     #     #
# ### # ##### # # ##### # ##### # ######### # # ###
#   #   #   # #       #   #     #         # # #   #
### ##### # # ####### # # # ############# # ### # #
#   #     # #     # # # # # #                   # #
# # # ##### ##### # # # # # ### ########### # ### #
# #   #   #     # #   #   #   #   #       # #   # #
# ##### # ### # # # ######### ##### ##### ### ### #
#     # # #   # # # #         #     #   # #   #   #
## ## # ### ### # # ### # # # # ##### # # # ### # #
#   # # #   #   # #   # # #       # # # #   #   # #
# # # # # ##### # ### # # # ##### # # # #  ## ### #
# #   #       # #   #   # #     #   # # #   # #   #
# ##### ##### # ### ##### # ### # ### # ### # ### #
#   #   #   # #   # #   # # #         # #   #   # #
# # # ### # # # # # ### # # ########### ####### # #
# #     # # #   # #   #   # #     #   #     #   # #
# ### ### # ##### ### ### # # ###   # ##### # ### #
#   # #   #     #       # # # # # # #       # #   #
# # ### #### ## ####### # # # # # ### ####### # ###
# # #   #       #   #   # #     #   # #       #   #
# # # ### # ### # # # ####### ##### # # # ####### #
# #   #   # #   # # # #     # #   # # # #   # #   #
# ##### # # ##### # # # ### ### # # # ##### # #  ##
#       # #       #     #       #   #       #    B#
###################################################