###################################################
#A  #       #       #                   #       # #
### # # ##### # ### ######## ## ##### # # ### # # #
# # # #     # #   #     #     #   #   # # # #     #
# # # ##### # ### ##### # ### ##### ##### # # ### #
#   # #   #   #   #   #   # # #   #         #   # #
# ### # # ##### ##### ##### # # # ########### # ###
# #     #     #     #       #   #           # #   #
# ######### ##### # ### # ################# # ### #
#   #       #   #     # #         #     #   # #   #
### # ####### # ##### # ####### # # # ### ##### # #
#   # #     # #       # # #   # # # #     #     # #
# ### # # ### ######### # # # # ### ###   # #######
#   #   # #   # #       #   # #     #   # #       #
### ####### ### # ########### ####### ### # ##### #
# #         #   #   #         # #     #   #     # #
# ########### ##### # ####### # # ###   ######### #
#           #     # # #   # # # # # # # #     #   #
# ### ### ### # # # # # # # # # # # # # # ### # # #
# #   #   #   # # #   # #   # # #     # # #     # #
# # ### ### ### ####### # ### # # ##### # ####### #
# # #     #   #   #     # #   # #     # #     #   #
# # ##### # # ### # # ##### ### ##### # # ### # ###
# #   #   #     # # # #   # #       #   #   # # # #
# ### ### ##### # # # # # # # # ########### # # # #
# # #   #   #   #   #   #   # # #   #       # #   #
#   ### ##### ############### # # # # ####### ### #
# #   #       #         #   # # # #   #           #
# # # ######### ### ### # # ### # ##### ####### ###
#   #         #   # #     #     # #   # # #     # #
############# ##### # ########### ### # # # ##### #
#         #   #     #   #             # # #       #
# ####### # ### ######### ############# # ####### #
# #       # #   #         #   #       # #       # #
# ##### ### # # # ### ##### # # ## ## # # ### ### #
#     # #   # #   #     #   # # #       # # #   # #
##### # # ### # ### # # #####   # # ##### # ### # #
#     # #   #   #             # # #   # #     # # #
# ##### ### # ### ######## ## # ### # # # ##### # #
#   #   #   #     #   #       #   # # #   #     # #
# #   ### ######### ### ######### # # ##### ##### #
# # #   #         #             #   #     # #     #
# # ############# # ######### # ######### # # ### #
# #           #   #   #     # #         # #   #   #
# ### # ##### # ##### # ### #   ##### ### # ### ###
#   #   #   # # #     # #   #   #     #   #   #   #
# # # ### # # # ####### ### ##### ##### ###   ### #
# # #   # #   #           #   #   #     # #   #   #
# # ### ############# ### ### ##### ##### # ### # #
#     #                   #         #           #B#
###################################################