###################################################
#A        #   #   #   #       #   #   #           #
######### ### # # # # # # ### # # # # ### ####### #
#       #   #   #   #   # #   # # # # #   #     # #
# ##### ### # ### ####### # ### # # # # ##### #   #
#     # #   # #     #   # # #   #   #   #     # # #
### ### # ### # # # # ### # # # ######### ##### # #
#   #   # #     # # # #   #   # #   # #   # #   # #
##### # # ### ### # # # ######### # # # # # # ### #
#     # #   # #   # # # #   #     # #   # #     # #
# ######### # # ### # # # # # ##### ##### ### ### #
# #         #   #     # # # #   # #     #   # #   #
# # ######### ####### # # # ### # ##### ### ### ###
#   #   #     #   #   # # #   #       #   #       #
# ### ### ##### # ##### # ### ####### ### ### ### #
#   #     #     #     # # # #           #   #   # #
##  #  #### ######### # # # ############### ### # #
#   #   #   #     #   # # #     #         #   #   #
# ####### ### ### # ### # # ##### ####### ### ### #
#         # # # #   #   #   #     #   #   #   #   #
########### # # ## ## # # ### ## ## # # ### # ## ##
#       #     #       # # #   #   # #   #   # #   #
# ### ### ######### ### # # ### # # # ### ##### # #
#   #     #       # # # # # #   # #     #   #   # #
### ####### ##### # # # # # # ### ##### # # # ### #
# #   #     #     #   #   #     # #   # # # # #   #
# ### # #####  #### ##### ####### # # # #   # # # #
#   #   #   #   #   #   #   #   # # # # # #   # # #
# ####### # ### ### # # ##### # # # ### ####### ###
#         #   #   # # #       #   #     #     #   #
# # ######### ### ### ############# ##### ### ### #
# # #         # #   # #   #       #   #   # #     #
### ##### ##### ### # # # # ### # ### # ### ##### #
#   #   #         #   # # #   # # # #   #     #   #
# ### # ######### ##### # ### #   # ######### # ###
# #   # #   #         # # #   #     #         #   #
# # ### # ### ####### # # # ### # # # ####### ### #
#   #   #     #     # # #   # # #   #   #       # #
# ### ######### ### ### ##### # ### ### # # ##### #
#   #   #       #   #   #     #   #     #     #   #
### ### # ####### ### ### ####### ##  ######### ###
# #   #   #     #     #         # #   #       #   #
# ### ####### # ############### # ##### ##### ### #
#   # #       # # #         #   #           #   # #
# ### # # ### #   # # ##### # ################# # #
#   # # #   #   #   # #       #       #         # #
# # # ### # # # ##### ######### # # # # ######### #
# # #   # # # #     #           # # # #     #   # #
# # ### ###   # ### ########## ## # # ##### # # # #
# #         #   #                 #       #   #  B#
###################################################