###################################################
#A#                   # #           #   #         #
# # # ############### # # ####### # # # # ####### #
# # #       # #       #   # #     #   # #   # #   #
# # ####### # # ####### ### # ######### ### # #  ##
# #   #   # #   #     #     # # #     #     # #   #
# ### ### # # ##### # ##### # # # # # ####### ### #
# #       # #       #         #     #         #   #
# ######### ################### ### # ##### # # ###
# #   #   # #               #   # # # #     #   # #
# # # # # # # ##### ####### # ### # # # ######### #
#   # # #   #     # #   #   # #   # # # #         #
##### # ######### # # # ##### ### # #   ### ##### #
#   #   #       # #   # #     #     # #     #   # #
# ####### ### # # ##### # ##### ### # ######### # #
#       # # # # #   #   # # #     # # #         # #
# # # ### # # # ##### ### # # ### # ### ##### ### #
# # #       # #       #   #   # # #     #   #     #
# # ####### # ####### # ### # # # #######   #######
#         # #     #   #   #   # #         #     # #
##### ### ##### # # ##### ### # ##### ######### # #
#   # #       # # #   # #   #   # #   #   #   # # #
# # # ####### ### ### # ### ### # # ### # # # # # #
# # #       #     #     #   #     # #   # # #   # #
# # ####### ### # ####### ######### # # # # ##### #
# #         # # #   #   # #           # # #       #
# ########### # ### # # # # ########### # ####### #
#   #         #   #   # #   #         # # #     # #
# # ####### # ### ##### ####### ##### # ### # ### #
# #       # #   #       #       #   #   #   # #   #
# ####### # ### #### ## # ####### # ### # ### # ###
# #       # # #       # #   #     #   # #   #   # #
# # ####### # # ####### #   # ####### # ### ##### #
# # #     # # #         # # #     #   #   # #   # #
### # ### # # ########### # ##### # # ### #   # # #
#   #   # # #     #     # #   #   # # #   #       #
# ##### ### ### # # ### # ### ##### ### ######### #
# #   # #   #   #   # # #   #   #   #   #     # # #
# # # # # ### ####### # ####### # ### ### ### # # #
#   # #   #     #           #   #       #   # # # #
##### # ####### ##### ##### # ######### ### # # # #
#     #       # #   # #   #   #     #       #   # #
# ########### # # # ### # ##### ### # ####### ### #
#   #   #   #   # #     #     # # # # #   #   #   #
# # # # # ### ### ########### # # # ### # ##### ###
# # # # #     #   #   #     #   # #     #   #   # #
# # # # ####### ### # ### # ##### ######### # ### #
# #   #   #   # #   #   #         #   #   # #   # #
# ####### # # # ### ### ### ##### # # ### # # # # #
#       #   #       #       #       #     #      B#
###################################################