###############################
#A                    #     # #
## ###### # ### ##### # ### # #
#       # #     #   # #   #   #
# # ##### # ##### # # #   ### #
# #       # #     #   # # # # #
# ######### # ########### # # #
# #         #   #         #   #
# # # ######### ### ####### ###
# # # # #     #   # #     #   #
# ### # # ### ### # ### # ### #
#     #   #     # #   # #   # #
## ######## # ### ### # # ### #
#           # #   #   # #     #
# ########### # ### ##### #####
#   #       # #   #     # #   #
# #   ##### # ### ##### # ### #
# # # #     # # #   #   # #   #
# # # # ##### # ### # ### # # #
# # # #     #     # #   # # # #
# # # ######### ### # # # # ###
# # #           #   # # # #   #
### ####### ##### ##### # # # #
#   #     #     #   #   # # # #
# # # ### ######### # ### ### #
# # # #   #       # # #   #   #
# ### # # # ##### # # # ### # #
#     # # # #     #   #   # # #
# ##### ### # # ######### # # #
#     #     #               #B#
###############################