###############################
#A          #     #           #
###### #### # ### # ######### #
# #     # #   #   #         # #
# # # # # ##### ##### ####### #
#     # #     #     # #     # #
# ### # ##### ##### ### ### # #
# # # # #         #   #   #   #
#   # # # ### ####### ### ### #
#   # # # # # #     #   #     #
### # # # # # # ### # # ##### #
#   # #   #   #   #   # #     #
# ### ### ####### # ### # ### #
#   #   # #       #     #   # #
### ### ### ############### ###
# #   # #   #     #       #   #
# ###   # ### ### ##### # ### #
# #   # #   # #     #   # #   #
# # ### ### # ##### # ### # # #
# #   #   # #   #     # #   # #
# ### ### # # # ####### ##### #
#   # # #   # #       #       #
# ### # ####### ### # #########
#   #         #     #         #
### ######### ### ####### ### #
#       #   # #   #     #   # #
# # ##### # # # ### ### #   # #
# # #   # #   #   # # #   #   #
# ### # # ######### # ####### #
#     #             #        B#
###############################