###############################
#A      #   #   #       #     #
####### # # # # ### ### ##### #
#     # # #   #     # # #   # #
# ### # # ########### # # # # #
# # #   # #           # # # # #
# # ##### # ######### # # # # #
#   #     #       # #   # #   #
### ### ######### # ##### #####
# #   # #   #     #           #
# ### # # ### ##### ######### #
#   #   # #   #       #   #   #
### ### # # ### ####### # #   #
#         # #       #   # # # #
# ######### ## ###### ### # # #
#   #     #     #     # # # # #
### # ### ##### # ##### # # # #
#   # # #     #   #   #   #   #
# ### # ### ####### # # ##### #
#     # #           # #       #
# ##### # ### ##### ###### ## #
#     # #     # #           # #
##### # ####### # ### ##### # #
#   #   #       #   # #     # #
# ##### # # ### ### # # # # # #
# #     # # #   # # #   # #   #
# # ##### # ### # # ##### #####
# # #     #     # #   #   #   #
# # ######### # # # ### # #   #
#             #   #         #B#
###############################