###############################
#A#         #   #     #       #
# # ### # # # # ### # ####### #
# #   #   # # #   #           #
# ### ### # # ### # ######### #
# #   # # #   # # # #     #   #
# # ### # ##### # # # ### # ###
# #     #   #   # #     # # # #
# ##### ### ### # # ##### # # #
# #   #   #   #   # #     # # #
# # # ### ### # # # # ##### # #
# # # #     # #   # #   # #   #
# # # # ##### # ##### # # ### #
# # # # #     #         #   # #
# ### # # ############### # # #
#   #   # #         #     # # #
### # ### ### # ##### # ### # #
#   #   #   # #       #   # # #
# ### # ### # ####### ### ### #
#   # #     #   #         #   #
### ### ####### # ######### ###
# #   #   #     #     #     # #
# ### ### # ######### # ##### #
#   #     #         #   #   # #
# # ############### ### # # # #
# #         #     #   #   #   #
# ### ##### ##### ### # ##### #
# # # #   #       #   # #   # #
# # # # # ######### ### # # # #
#   #   #               # #  B#
###############################