###############################
#A#   #             #     #   #
# # # # # ######### ### # # # #
# # #   #   #       #   # # # #
# # ####### # ### ### ### # ###
# #     #   # #       # # #   #
# ##### # # # # ####### # ### #
# #     # # # #     #   # #   #
# ### ### # # # ### # ### # # #
#   # #   # # # # # #   #   # #
### ### ### # # # # # # ##### #
# #     # #   # # # # #   #   #
# ####### # ### # # # ### # ###
#         #   #   # # #   # # #
# ##### # ### ##### # # # # # #
#   #   #   #       # # #   # #
### # ##### ####### # # # # # #
#   #   #   #   #     # #     #
# ##### ##### # # # ### ##### #
#   # #       #   #   #     # #
### # ############# # ### ### #
# # #           #   #     #   #
# #   ####### ### ##### ### ###
#   # #     # #   #   # #   # #
# ##### ### # # ###   ### ### #
#   #   # #   #   # #   #     #
### # ### ### ### # ### ##### #
# #         # # #     #   #   #
# ##### # ### # # ### ### # ###
#       #       #       #    B#
###############################